+-+-+-+-+-+-+-+-+-+-+-+-+-+-+-+-+-+-+-+-+-+-+-+-+-+-+-+
############|   |       |#####|#######|       |   |   |
+-+-+-+-+-+#+-+ + +-+-+ +#+-+#+#+-+#+#+ +-+-+ + + +-+ +
|#####|    #|   | |     |#|###|#| | |#|   |     |     |
+#+#+#+-+-+#+ +-+ + +-+-+#+#+-+#+ + +#+-+-+ +-+-+ + +-+
|#| |#|#####|   | | |   |#|#|###|   |#####  |     |   |
+#+-+#+#+-+-+-+ + + +-+ +#+#+#+-+-+-+-+-+#+-+ +-+-+ +-+
|#|###|###|  ###| |   | |#|#|#|  #########|   |   |   |
+#+#+-+#+#+-+#+#+ +-+ + +#+#+#+ +#+-+-+-+-+ +-+-+ +-+-+
|#|###| |#|###|#| |   | |#|###| |#|   |           |   |
+#+-+#+-+#+#+-+#+-+ +-+ +#+-+-+ +#+ +-+ +-+ +-+-+-+ +-+
|###|#####|###|#########|#|     |#|     | | |   | |   |
+-+#+-+-+-+-+#+-+-+#+-+#+#+ +-+-+#+-+-+-+ + + + + + +-+
|  #########|#|   |   |###|   |###|###|   |   | | |   |
+ +-+-+#+-+#+#+ + +-+ +-+-+-+ +#+-+#+#+ +-+-+ + + +-+ +
| | |     |#|## | |   |       |#|###|#|       |   |   |
+ + + +-+ +#+#+-+ + +-+-+-+-+-+#+#+#+#+-+-+-+-+-+-+-+-+
| | | |   |#|#| |       |     |#|#| |#######|     |   |
+ + + + +-+#+#+ +-+ +-+ + +-+ +#+#+-+-+-+-+#+ +-+ + +-+
|   | |   |###|   | |   |   | |###|     |#######| |   |
+-+-+ +-+ +-+-+-+ +-+ +-+-+-+ +-+-+ +-+ +#+-+#+#+-+-+ +
|   |   | |     |     |     | |   |   | |###|#|###|   |
+ + +-+-+ + +-+ +-+ +-+-+-+ + +-+ +-+-+ +-+#+#+-+#+-+-+
|         |   |     |   |     |     |   |  ###|  ######
+-+-+-+-+-+-+-+-+-+-+-+-+-+-+-+-+-+-+-+-+-+-+-+-+-+-+-+
