+-+-+-+-+-+-+-+-+-+-+-+-+-+-+-+-+-+-+-+-+-+-+-+-+-+
############|   |       |#####|#######|       |   |
+-+-+-+-+-+#+-+ + +-+-+ +#+-+#+#+-+#+#+ +-+-+ + + +
|#####|    #|   | |     |#|###|#| | |#|   |     | |
+#+#+#+-+-+#+ +-+ + +-+-+#+#+-+#+ + +#+-+-+ +-+-+ +
|#| |#|#####|   | | |   |#|#|###|   |#####  |     |
+#+-+#+#+-+-+-+ + + +-+ +#+#+#+-+-+-+-+-+#+-+ +-+-+
|#|###|###|  ###| |   | |#|#|#|  #########|   |   |
+#+#+-+#+#+-+#+#+ +-+ + +#+#+#+ +#+-+-+-+-+ +-+-+ +
|#|###| |#|###|#| |   | |#|###| |#|   |           |
+#+-+#+-+#+#+-+#+-+ +-+ +#+-+-+ +#+ +-+ +-+ +-+-+-+
|###|#####|###|#########|#|     |#|     | | |   | |
+-+#+-+-+-+-+#+-+-+#+-+#+#+ +-+-+#+-+-+-+ + + + + +
|  #########|#|   |   |###|   |###|###|   |   | | |
+ +-+-+#+-+#+#+ + +-+ +-+-+-+ +#+-+#+#+ +-+-+ + + +
| | |     |#|## | |   |       |#|###|#|       |   |
+ + + +-+ +#+#+-+ + +-+-+-+-+-+#+#+#+#+-+-+-+-+-+-+
| | | |   |#|#| |       |     |#|#| |#######|     |
+ + + + +-+#+#+ +-+ +-+ + +-+ +#+#+-+-+-+-+#+ +-+ +
|   | |   |###|   | |   |   | |###|     |#######| |
+-+-+ +-+ +-+-+-+ +-+ +-+-+-+ +-+-+ +-+ +#+-+#+#+-+
|   |   | |     |     |     | |   |   | |###|#|###|
+ + +-+-+ + +-+ +-+ +-+-+-+ + +-+ +-+-+ +-+#+#+-+#+
|         |   |     |   |     |     |   |  ###|  ##
+-+-+-+-+-+-+-+-+-+-+-+-+-+-+-+-+-+-+-+-+-+-+-+-+-+
