+-+-+-+-+-+-+-+-+-+-+-+-+-+-+-+-+-+-+-+-+-+-+-+-+-+
############|   |       |     |       |       |   |
+-+-+-+-+-+#+-+ + +-+-+ + +-+ + +-+ + + +-+-+ + + +
|#####|   ##|   | |     | |   | | | | |   |     | |
+#+ +#+-+-+#+ +-+ + +-+-+ + +-+ + + + +-+-+ +-+-+ +
|#| |#|#####|   | | |   | | |   |   |   |   |     |
+#+-+#+#+-+-+-+ + + +-+ + + + +-+-+-+-+-+ +-+ +-+-+
|#|###|###|   | | |   | | | | |           |   |   |
+#+#+-+#+#+-+ + + +-+ + + + + + + +-+-+-+-+ +-+-+ +
|#|###| |#|   | | |   | | |   | | |   |           |
+#+-+#+-+#+ +-+ +-+ +-+ + +-+-+ + + +-+ +-+ +-+-+-+
|###|#####|   |         | |     | |     | | |   | |
+-+#+-+-+-+-+ +-+-+ +-+ + + +-+-+ +-+-+-+ + + + + +
| ######    | |   |   |   |   |   |   |   |   | | |
+ +-+-+#+-+ + + + +-+ +-+-+-+ + +-+ + + +-+-+ + + +
| | | ####| |   | |   |       | |   | |       |   |
+ + + +-+#+ + +-+ + +-+-+-+-+-+ + + + +-+-+-+-+-+-+
| | | |###| | | |       |     | | | |       |     |
+ + + +#+-+ + + +-+ +-+ + +-+ + + +-+-+-+-+ + +-+ +
|   | |###|   |   | |   |   | |   |     |       | |
+-+-+ +-+#+-+-+-+ +-+ +-+-+-+ +-+-+ +-+ + +-+ + +-+
|###|   |#|     |     |     | |   |   | |   | |   |
+#+#+-+-+#+ +-+ +-+ +-+-+-+ + +-+ +-+-+ +-+ + +-+ +
|#|###|###| |   |   |           | |         |   | |
+#+-+#+#+-+ + +-+ +-+ +-+-+-+ + + + +-+-+-+-+ + +-+
|#|###|#| | |     |     |     |   | |   |     |   |
+#+#+-+#+ + +-+-+-+ +-+-+ + +-+-+-+ +-+ + +-+-+-+ +
|#|#####|   |###  | |   | | |     |     |   |###| |
+#+-+-+-+-+-+#+#+-+ + + + +-+ +-+ + +-+-+-+-+#+#+ +
|#|#####|   |#|#|   | | | |   |   |     |#####|#  |
+#+#+-+#+ + +#+#+#+-+-+ + + +-+ +-+-+-+-+#+-+-+#+-+
|###|###| | |#|#|#####| |   |   |#########| |###  |
+-+-+#+ + + +#+#+#+-+#+ +-+-+ +-+#+-+-+-+-+ +#+-+-+
|   |#| | | |#|###|###| |   | |###|   |   | |#|###|
+ + +#+ + + +#+-+ +#+-+ + + + +#+-+ + + + + +#+#+#+
| | |#| | | |###| |###| | |   |#|   |   |   |###|#|
+ +-+#+ +-+ +-+#+-+-+#+ +-+-+-+#+ +-+ +-+-+ +-+-+#+
| | ##|   | | |#|   |#|     |###|   |     | |#####|
+ + +#+-+ + +#+#+ + +#+-+ + +#+-+-+ +-+-+ +-+#+-+-+
|   |###|   |###| | ##    | |#|     |       |###| |
+-+-+-+#+-+-+#+-+ +-+#+-+-+ +#+ +-+-+-+-+ + +#+#+ +
|     |#######|   |###|     |#|     |     |   |#| |
+ +-+ +-+-+-+-+ +-+#+-+-+-+-+#+ +-+ + +-+-+-+-+#+#+
|   |   |       |###|#######|#| |   |         |###|
+-+ +-+ + +-+-+-+#+-+#+-+-+#+#+ + +-+-+-+-+-+ +-+#+
|     | | |#######|###|   |###| |   |     |   | ##|
+ + + +-+ +#+-+-+-+#+-+ + +-+-+-+-+ + +-+ + +-+-+#+
| | |     |#|#######| | |   |   | | |   |   |   |#|
+ +-+-+-+-+#+#+-+-+ + + + +-+ + + + +-+ +-+-+ + +#+
|         |###|     |   |     |     |   |     | ###
+-+-+-+-+-+-+-+-+-+-+-+-+-+-+-+-+-+-+-+-+-+-+-+-+-+
