+-+-+-+-+-+-+-+-+-+-+-+-+-+-+-+-+-+-+-+-+-+-+-+-+-+-+-+
############|   |       |#####|#######|       |   |   |
+-+-+-+-+-+#+-+ + +-+-+ +#+-+#+#+-+#+#+ +-+-+ + + +-+ +
|#####|   ##|   | |     |#|###|#| | |#|   |     |     |
+#+ +#+-+-+#+ +-+ + +-+-+#+#+-+#+ + +#+-+-+ +-+-+ + +-+
|#| |#|#####|   | | |   |#|#|###|   |#####  |     |   |
+#+-+#+#+-+-+-+ + + +-+ +#+#+#+-+-+-+-+-+#+-+ +-+-+ +-+
|#|###|###|     | |   | |#|#|#| ##########|   |   |   |
+#+#+-+#+#+-+ + + +-+ + +#+#+#+ +#+-+-+-+-+ +-+-+ +-+-+
|#|###| |#|   | | |   | |#|###| |#|   |           |   |
+#+-+#+-+#+ +-+ +-+#+-+#+#+-+-+ +#+ +-+ +-+ +-+-+-+ +-+
|###|#####|   |   ######|#|     |#|     | | |   | |   |
+-+#+-+-+-+-+ +-+-+#+-+#+#+ +-+-+#+-+-+-+ + + + + + +-+
| ##########| |###|###|###|   |###|###|   |   | | |   |
+ +-+-+#+-+#+#+#+#+-+#+-+-+-+ +#+-+#+#+ +-+-+ + + +-+ +
| | |     |#|###|#|###|       |#|###|#|       |   |   |
+ + + +-+ +#+#+-+#+#+-+-+-+-+-+#+#+ +#+-+-+-+-+-+-+-+-+
| | | |   |#|#| |###    |     |#|#| |#######|     |   |
+ + + + +-+#+#+ +-+ +-+ + +-+ +#+#+-+-+-+-+#+#+-+ + +-+
|   | |   |###|   | |   |   | |###|     | ######| |   |
+-+-+ +-+ +-+-+-+ +-+ +-+-+-+ +-+-+ +-+ + +-+#+#+-+-+ +
|   |   | |     |     |     | |   |   | |   | |###|   |
+ + +-+-+ + +-+ +-+ +-+-+-+ + +-+ +-+-+ +-+ + +-+#+-+-+
|         |   |     |   |     |     |   |     | #######
+-+-+-+-+-+-+-+-+-+-+-+-+-+-+-+-+-+-+-+-+-+-+-+-+-+-+-+
