+-+-+-+-+-+-+-+-+-+-+-+-+-+-+-+-+-+-+-+-+-+-+-+-+-+
############|   |       |#####|#######|       |   |
+-+-+-+-+-+#+-+ + +-+-+ +#+-+#+#+-+#+#+ +-+-+ + + +
|#####|   ##|   | |     |#|###|#| | |#|   |     | |
+#+ +#+-+-+#+ +-+ + +-+-+#+#+-+#+ + +#+-+-+ +-+-+ +
|#| |#|#####|   | | |   |#|#|###|   |#####  |     |
+#+-+#+#+-+-+-+ + + +-+ +#+#+#+-+-+-+-+-+#+-+ +-+-+
|#|###|###|     | |   | |#|#|#| ##########|   |   |
+#+#+-+#+#+-+ + + +-+ + +#+#+#+ +#+-+-+-+-+ +-+-+ +
|#|###| |#|   | | |   | |#|###| |#|   |           |
+#+-+#+-+#+ +-+ +-+#+-+#+#+-+-+ +#+ +-+ +-+ +-+-+-+
|###|#####|   |   ######|#|     |#|     | | |   | |
+-+#+-+-+-+-+ +-+-+#+-+#+#+ +-+-+#+-+-+-+ + + + + +
| ##########| |###|###|###|   |###|###|   |   | | |
+ +-+-+#+-+#+#+#+#+-+#+-+-+-+ +#+-+#+#+ +-+-+ + + +
| | |     |#|###|#|###|       |#|###|#|       |   |
+ + + +-+ +#+#+-+#+#+-+-+-+-+-+#+#+ +#+-+-+-+-+-+-+
| | | |   |#|#| |###    |     |#|#| |#######|     |
+ + + + +-+#+#+ +-+ +-+ + +-+ +#+#+-+-+-+-+#+#+-+ +
|   | |   |###|   | |   |   | |###|     | ######| |
+-+-+ +-+ +-+-+-+ +-+ +-+-+-+ +-+-+ +-+ + +-+#+#+-+
|   |   | |     |     |     | |   |   | |   | |###|
+ + +-+-+ + +-+ +-+ +-+-+-+ + +-+ +-+-+ +-+ + +-+#+
|         |   |     |   |     |     |   |     | ###
+-+-+-+-+-+-+-+-+-+-+-+-+-+-+-+-+-+-+-+-+-+-+-+-+-+
